111111111111111111111111111111111
100000000000000000000000000000001
100000000000000000000000000000001
100000000000000000000000000000001
100000000000000000000000000000001
100000000000000000000000000000001
100000000000000000000000000000001
100000000000000000000000000000001
100000001111111000011111110000001
100000001110001000010001110000001
100004001110000000000001110400001
100000001110000000000001110000001
100000001110000000000001110000001
100000001110000000000001110000001
100000001110000004000001110000001
100000001110000000000001110000001
100000001115000000000061110000001
100000001115000000000061110000001
100000001115000000000061110000001
100000001111188111177111110000001
100000001111111111111111110000001
100000000000000000000000000000001
100000000000000000000000000000001
100000000000000000000000000000001
1****10000000000040000000001****1
111111000000000000000000000111111
111111771110000000000011188111111
111111111110000111100011111111111
111111111110000111100001111111111
100004000000000111100000004000001
100000000000001111110000000000001
100000000000001111110000000000001
111111777777111111111188888811111