111111111111111111111111111111111
100000000000000000000000000000001
100000000000000000000000000000001
100000000000000000000000000000001
100000000000000000000000000000001
100000000004000000000000005006001
100000000000000000000000005006001
100000000000000000000000005006001
100000001111111999911111111111111
111000001111111111111111111111111
111000001111111111111111111111111
111000000000000000000000000000001
111110000000004000000000000000001
111110000000000000000000000000001
111111111111111111111111111000001
111111111000003000000000011000011
100000000000003000000000000000011
100000000000003000000000000000011
100000000000003000000004000000111
100000000110003000220000000000111
102200000111111111111111111111111
111111000000000000000000000011111
111111004000000000000000000000001
111111000000000000000000000000001
111111111111111100004000000000001
100000000000000100000000000000001
100000000000000111111188111000001
100000000000000000000000011000001
111111111111000000000000000000011
111111111111000000000000000000111
111111111111000400000000000000111
111111111111000000000000000000111
111111111111111111881177111111111