111111111111111111111111111111111
100000000000000000000000000000001
100000000000000000000000000000001
100000000000000004000000000000001
100000000000000000000000000000001
150060000000000000000000000000001
150060000000000000000000000000001
150060000000000000000000000000001
111111111111100000000000000000001
111111111111140000000000000000001
111111111111100000000000000000001
111111111111100111000000000000001
111111111111100111000000000000001
111111111111100111000000000000001
111111111111199111111111111000001
111111111111111111111111111000001
100000000000000000000000000000111
100000000000004000000000000000111
100000000000000000000000000000111
100000000110000000110000000011111
102200000118111119117111111911111
111111000003000000000000000011111
111111000003000004000000000000001
111111000003000000000022000000001
111111111111111111111111100000001
100000000000000000000001111000001
100000000004000000000001111000011
100000000000000000000000000000011
111111000000000000000000000000111
100001000000000000000000000000111
100000000000040000000000000001111
100000000000000000000000000001111
111117777771111888888111111111111